
NO./maps/textures/redbrick.xpm
F 66,38,0

C    210,180,140
                SO ./maps/textures/redbrick.xpm
   WE     ./maps/textures/eagle.xpm
EA                                 ./maps/textures/eagle.xpm

        1111111111111111111111111        1111111111111111111111111         
        1000000000110000000000001        100000000110000010000001 
        1011000001110000000000001        100000S001110000010000001 
        1001000000000000000000001        1000000000000000000000001
111111111011000001010000010000001111111111011000111010000010000001
1000000000110000011111011111111111  100000000001000001111111111111111
11110111111111111100000010001111100000000000000000000000011
1111011111111101110101000000111110000000000000000000000001
1100000011010101111000001000000000000000000000000000000001
100000001000000011000001000111100000000000000000000000000111
1000000000000000110101001000110000000000000000000000000001
1100000111010101111111111001110000000000000000000000000011
11111111 10100000000000111111111111111011111000000011011
1111111111011111111111011           1101111111111111101111111  
1000000000000000000000001          1000000000110000010000001    
1011000001110000000000001         1011000001110000010000001   
10010000000000000000000011111111   100100000000000000000001111111
111111111011000001010000000000001111111111011100001010000010000001
100000000011000001111101111111111100000000011000001111101111111111
11110111111111111100000010001111100111111111011100000010001
1111011111111101110101000000111110111111111011101010000001
1100000011010101111000001000111000000110101011110000010001
10000000100000001100001000000000000001000000011000001000111
1000000000000000110101001000110000000000000001101010010001
110000011101010111110111100111000001110101011111011110011
11111111 101111111111111111111111111 1011111111111111111
          1                           1
