NO./maps/textures/n.xpm
F 10,20,230




C    0,200,255

                SO ./maps/textures/s.xpm
   WE    
	 EA                                 ./maps/textures/e.xpm

        11111111111111 1111111111
        1010000000110101010100001
        1111000001110000010100001
        100100000110000000000001
111111111001000001110000000000001
100000000001000001110000111111111
11110111111111011100000000001
11110111111111011100000000001
1100000011010101110000N000001
10000000000000000100000000111
10000000000000001101001000011
110000011100000111111001000011
11110111 1100001 101111000001
11111111 1111111 111111111111
